1111111
1P1E101
10C0101
1111110