1111111
1PE0101
10C0101
1111110