1111111
1P01111
100CE01
1111111