1111111
10P00C1
1C001E1
1111111