111111111111111111111111111111
10000000000C000000100000000001
1000X0000000000000000000000001
10001111110000000010000C000001
100001000000000000100000000001
1000010000000C0000100000000001
100001000000000000100000000001
1000010000000X0000100000000001
1000010000000000001C1111111111
100001C00000000000100000000001
1000010000000000001000000PE001
111111111111111111111111111111